+++++++++++++++++++++++
+A                    +
+                     +
+                   + +
+                   + +
+                   + +
+                   + +
+                   + +
+                   + +
+                   + +
+                   + +
+                   + +
+                   + +
+                   + +
+                   +A+
+0                  +a+
+++++++++++++++++++++++
