+++++++++++++++
+             +
+   A     A   +
+             +
+             +
+   A     A   +
+             +
+             +
+   A     A   +
+             +
+             +
+             +
+             +
+             +
+             +
+             +
+             +
+             +
+             +
+             +
+             +
+      A      +
+             +
+      0      +
+      a      +
+++++++++++++++